10 10
...#######
.#....#..#
..#...#..#
...#.....#
#...#....#
##...#...#
#........#
#..#......
..###.....
#......###
